1111111111111111111111111
1000000000000000000000001
10p0300030003000300030001
1000300030003000300030001
1000200020003000300020001
1000200030003000300030001
1000300030005000300030001
1000300040005000400040001
1000300030003000400030001
1000300030003000300030001
1000200050003000300030001
1000200030003000300030001
1000300030003000300030001
10000000000000000000000w1
1111111111111111111111111
