1111111111111
1p000010000w111
1000000000000001
100111010111011
1000001000001111111111
1000000000000000000001
111011101011111111111
1000000000000000000001
10000000000000000000001
1111111111111111110000111
1000000000000000000000001
100000000000111111111111
1111111111111

