1111111111111
1p000030000w111
1000000000000001
100444020444011
1000004000003333333333
1000000000000000000001
1220555010333333333331
1000000000000000000001
10000000000000000000001
133333333333333330000111
1000000000000000000000001
100000000000111111111111
333333333333

