1111111111111
1p000010000w1
1011101011101
1000001000001
1110111010111
1000000000001
1111111111111

